furywarrior	MazonAddon/Combat/WarriorFury.lua
dhtankpvp	MazonAddon/Combat/DHTankPvp.lua
boomkin	MazonAddon/Combat/DruidBoomkin.lua
furypvp	MazonAddon/Combat/WarriorFuryPvp.lua
protwarrior	MazonAddon/Combat/WarriorProt.lua
protwarrior2	MazonAddon/Combat/WarriorProt2.lua
armswarrior	MazonAddon/Combat/WarriorArms.lua
arms	MazonAddon/Combat/WarriorArms2.lua
seller	MazonAddon/Combat/Seller.lua
fury	MazonAddon/Combat/WarriorFury2.lua
retpvp	MazonAddon/Combat/RetriPVP.lua
lockfollow	MazonAddon/Combat/ClassicLockFollower.lua
pvpwarr	MazonAddon/Combat/WarriorPvp.lua
bmhunter	MazonAddon/Combat/HunterBM.lua
mmhunter	MazonAddon/Combat/HunterMM.lua
eleshaman	MazonAddon/Combat/ShamanEle.lua
argus	MazonAddon/Combat/Argus.lua
elepvp	MazonAddon/Combat/ShamanElePvp.lua
enhshaman	MazonAddon/Combat/ShamanEnhancement.lua
enhshaman2	MazonAddon/Combat/ShamanEnhancement2.lua
restoshaman	MazonAddon/Combat/ShamanResto.lua
restoshaman2	MazonAddon/Combat/ShamanResto2.lua
bmmonk	MazonAddon/Combat/MonkBrewmaster.lua
mwmonk	MazonAddon/Combat/MonkMistweaver.lua
wwmonk	MazonAddon/Combat/MonkWindwalker.lua
wwmonk2	MazonAddon/Combat/MonkWindwalker2.lua
monkpvp	MazonAddon/Combat/MonkWindwalkerPvp.lua
blooddk	MazonAddon/Combat/DKBlood.lua
blooddk2	MazonAddon/Combat/DKBlood2.lua
unholydk	MazonAddon/Combat/DKUnholy.lua
unholydk2	MazonAddon/Combat/DKUnholy2.lua
pvpdk	MazonAddon/Combat/DKPvp.lua
pvpdk2	MazonAddon/Combat/DKPvp2.lua
restodruid	MazonAddon/Combat/DruidResto.lua
raiddruid	MazonAddon/Combat/DruidRestoRaid.lua
tankdruid	MazonAddon/Combat/DruidTank.lua
feraldruid	MazonAddon/Combat/DruidFeral.lua
convoke	MazonAddon/Combat/DruidConvoke.lua
pvpdruid	MazonAddon/Combat/DruidRestoPvp.lua
mmhunterfollower	MazonAddon/Combat/HunterMMFollower.lua
mwmonkfollower	MazonAddon/Combat/MonkMistweaverFollower.lua
eleshamanfollower	MazonAddon/Combat/ShamanEleFollower.lua
bmhunterfollower	MazonAddon/Combat/HunterBMFollower.lua
restofollower	MazonAddon/Combat/DruidRestoFollower.lua
resto2follower	MazonAddon/Combat/DruidResto2Follower.lua
dhdps	MazonAddon/Combat/DHHavoc.lua
dhtank	MazonAddon/Combat/DHTank.lua
classicarms	MazonAddon/Combat/WarriorClassicArms.lua
classicwarrior	MazonAddon/Combat/WarriorClassic.lua
classictank	MazonAddon/Combat/WarriorClassicTank.lua
classicshaman	MazonAddon/Combat/ShamanClassic.lua
classicdruid	MazonAddon/Combat/DruidClassic.lua
classicdruidfollower	MazonAddon/Combat/ClassicDruidFollower.lua
classicshamanfollower	MazonAddon/Combat/ClassicShamanFollower.lua
classichunterfollower	MazonAddon/Combat/ClassicHunterFollower.lua
classichunter	MazonAddon/Combat/ClassicHunter.lua
classicferal	MazonAddon/Combat/ClassicFeral.lua
classicfury	MazonAddon/Combat/WarriorClassicFury.lua
classicmage	MazonAddon/Combat/MageClassic.lua
classicrogue	MazonAddon/Combat/RogueClassic.lua
outlaw	MazonAddon/Combat/RogueOutlaw.lua
outlawpvp	MazonAddon/Combat/RogueOutlawPvp.lua
assa	MazonAddon/Combat/RogueAssasination.lua
pvp	MazonAddon/Combat/ClassicPVP.lua
firemage	MazonAddon/Combat/MageFire.lua
arcane	MazonAddon/Combat/MageArcane.lua
frostmage	MazonAddon/Combat/MageFrost.lua
mage	MazonAddon/Combat/MageLevel.lua
hordruid	MazonAddon/Combat/DruidRestoHorrific.lua
survhunter	MazonAddon/Combat/HunterSurvival.lua
survhunter2	MazonAddon/Combat/HunterSurvival2.lua
resto	MazonAddon/Combat/DruidResto2.lua
bmhunter2	MazonAddon/Combat/HunterBM2.lua
bmhunter3	MazonAddon/Combat/HunterBM3.lua
island	MazonAddon/Combat/IslandGroup.lua
destro	MazonAddon/Combat/Destro.lua
demo	MazonAddon/Combat/DemoLock.lua
demo2	MazonAddon/Combat/DemoLock2.lua
affli	MazonAddon/Combat/AffliLock.lua
afflipvp	MazonAddon/Combat/AffliLock2.lua
afflipve	MazonAddon/Combat/AffliPve.lua
group	MazonAddon/Combat/Group.lua
tailor	MazonAddon/Combat/Tailor.lua
demoLvl	MazonAddon/Combat/DemoLeveling.lua
pala	MazonAddon/Combat/Pala.lua
holypala	MazonAddon/Combat/PalaHoly.lua
palaraid	MazonAddon/Combat/PalaHolyRaider.lua
holypvp	MazonAddon/Combat/PalaHolyPvp.lua
protpala	MazonAddon/Combat/PalaTank.lua
retripala	MazonAddon/Combat/PalaRetri.lua
retripala2	MazonAddon/Combat/PalaRetri2.lua
skinner	MazonAddon/Combat/Skinner.lua
trial	MazonAddon/Combat/TrialSeller.lua
frostdk	MazonAddon/Combat/DKFrost.lua
disc	MazonAddon/Combat/PriestDisc.lua
protpvp	MazonAddon/Combat/WarriorProtPvp.lua
protdf	MazonAddon/Combat/WarriorProtDF.lua
condemn	MazonAddon/Combat/WarriorCondemn.lua
subtlety	MazonAddon/Combat/RogueSubtlety.lua
sub2	MazonAddon/Combat/RogueSubtlety2.lua
tbcmulti	MazonAddon/Combat/TBCMultibox.lua
evoker	MazonAddon/Combat/EvokerDps.lua